"filename", "language", "PHP", "Markdown", "CSS", "JavaScript", "comment", "blank", "total"
"e:\Work\WEB\wxxy-class\README.md", "Markdown", 0, 8, 0, 0, 0, 6, 14
"e:\Work\WEB\wxxy-class\admin\class_book.php", "PHP", 221, 0, 0, 0, 8, 3, 232
"e:\Work\WEB\wxxy-class\admin\class_book_create.php", "PHP", 112, 0, 0, 0, 6, 3, 121
"e:\Work\WEB\wxxy-class\admin\index.php", "PHP", 82, 0, 0, 0, 4, 1, 87
"e:\Work\WEB\wxxy-class\admin\module\head-check.php", "PHP", 38, 0, 0, 0, 6, 5, 49
"e:\Work\WEB\wxxy-class\admin\module\header.php", "PHP", 26, 0, 0, 0, 0, 0, 26
"e:\Work\WEB\wxxy-class\admin\module\menu.php", "PHP", 27, 0, 0, 0, 0, 0, 27
"e:\Work\WEB\wxxy-class\admin\plugins\class_book_change.php", "PHP", 77, 0, 0, 0, 14, 6, 97
"e:\Work\WEB\wxxy-class\admin\plugins\class_book_create.php", "PHP", 68, 0, 0, 0, 13, 6, 87
"e:\Work\WEB\wxxy-class\api\auth\changepassword.php", "PHP", 0, 0, 0, 0, 0, 1, 1
"e:\Work\WEB\wxxy-class\api\auth\login.php", "PHP", 35, 0, 0, 0, 17, 5, 57
"e:\Work\WEB\wxxy-class\api\avatar\index.php", "PHP", 16, 0, 0, 0, 13, 4, 33
"e:\Work\WEB\wxxy-class\api\class\info_change.php", "PHP", 111, 0, 0, 0, 33, 6, 150
"e:\Work\WEB\wxxy-class\api\class\person.php", "PHP", 104, 0, 0, 0, 24, 4, 132
"e:\Work\WEB\wxxy-class\api\class\task.php", "PHP", 146, 0, 0, 0, 31, 5, 182
"e:\Work\WEB\wxxy-class\api\class\task_change.php", "PHP", 66, 0, 0, 0, 20, 5, 91
"e:\Work\WEB\wxxy-class\api\class\task_create.php", "PHP", 46, 0, 0, 0, 15, 5, 66
"e:\Work\WEB\wxxy-class\api\get_book\change.php", "PHP", 36, 0, 0, 0, 15, 3, 54
"e:\Work\WEB\wxxy-class\api\get_book\index.php", "PHP", 29, 0, 0, 0, 12, 3, 44
"e:\Work\WEB\wxxy-class\api\header-control.php", "PHP", 4, 0, 0, 0, 6, 2, 12
"e:\Work\WEB\wxxy-class\api\index.php", "PHP", 8, 0, 0, 0, 7, 3, 18
"e:\Work\WEB\wxxy-class\api\main\index.php", "PHP", 50, 0, 0, 0, 16, 4, 70
"e:\Work\WEB\wxxy-class\api\main\mirrors.php", "PHP", 67, 0, 0, 0, 17, 4, 88
"e:\Work\WEB\wxxy-class\api\signin\index.php", "PHP", 92, 0, 0, 0, 22, 3, 117
"e:\Work\WEB\wxxy-class\auth.php", "PHP", 87, 0, 0, 0, 3, 2, 92
"e:\Work\WEB\wxxy-class\get_book.php", "PHP", 210, 0, 0, 0, 5, 2, 217
"e:\Work\WEB\wxxy-class\get_book_upload.php", "PHP", 42, 0, 0, 0, 10, 3, 55
"e:\Work\WEB\wxxy-class\index.php", "PHP", 163, 0, 0, 0, 4, 1, 168
"e:\Work\WEB\wxxy-class\member-ty.php", "PHP", 78, 0, 0, 0, 3, 1, 82
"e:\Work\WEB\wxxy-class\module\footer.php", "PHP", 23, 0, 0, 0, 0, 0, 23
"e:\Work\WEB\wxxy-class\module\head-check.php", "PHP", 35, 0, 0, 0, 5, 4, 44
"e:\Work\WEB\wxxy-class\module\header.php", "PHP", 39, 0, 0, 0, 0, 0, 39
"e:\Work\WEB\wxxy-class\module\menu.php", "PHP", 59, 0, 0, 0, 0, 0, 59
"e:\Work\WEB\wxxy-class\non-member-fty.php", "PHP", 78, 0, 0, 0, 3, 1, 82
"e:\Work\WEB\wxxy-class\nucleic_acid.php", "PHP", 78, 0, 0, 0, 3, 1, 82
"e:\Work\WEB\wxxy-class\pan.php", "PHP", 80, 0, 0, 0, 3, 1, 84
"e:\Work\WEB\wxxy-class\plugins\Parsedown.php", "PHP", 1074, 0, 0, 0, 322, 312, 1708
"e:\Work\WEB\wxxy-class\plugins\function.php", "PHP", 39, 0, 0, 0, 7, 5, 51
"e:\Work\WEB\wxxy-class\plugins\login.php", "PHP", 61, 0, 0, 0, 15, 4, 80
"e:\Work\WEB\wxxy-class\plugins\loginout.php", "PHP", 3, 0, 0, 0, 0, 0, 3
"e:\Work\WEB\wxxy-class\plugins\sql_conn.php", "PHP", 11, 0, 0, 0, 15, 1, 27
"e:\Work\WEB\wxxy-class\setting.php", "PHP", 133, 0, 0, 0, 3, 1, 137
"e:\Work\WEB\wxxy-class\setting_data_upload.php", "PHP", 74, 0, 0, 0, 13, 5, 92
"e:\Work\WEB\wxxy-class\signin\20220911.php", "PHP", 153, 0, 0, 0, 4, 2, 159
"e:\Work\WEB\wxxy-class\signin\admin_20220911.php", "PHP", 116, 0, 0, 0, 5, 2, 123
"e:\Work\WEB\wxxy-class\signin\index.php", "PHP", 89, 0, 0, 0, 3, 1, 93
"e:\Work\WEB\wxxy-class\signin\upload\20220911.php", "PHP", 63, 0, 0, 0, 10, 3, 76
"e:\Work\WEB\wxxy-class\src\css\bootstrap-icons.css", "CSS", 0, 0, 1874, 0, 0, 3, 1877
"e:\Work\WEB\wxxy-class\src\css\bootstrap.min.css", "CSS", 0, 0, 2, 0, 5, 0, 7
"e:\Work\WEB\wxxy-class\src\css\city-picker.css", "CSS", 0, 0, 138, 0, 0, 23, 161
"e:\Work\WEB\wxxy-class\src\css\qweather-icons.css", "CSS", 0, 0, 485, 0, 5, 4, 494
"e:\Work\WEB\wxxy-class\src\js\bootstrap.bundle.min.js", "JavaScript", 0, 0, 0, 1, 6, 0, 7
"e:\Work\WEB\wxxy-class\src\js\bootstrap.min.js", "JavaScript", 0, 0, 0, 1, 6, 0, 7
"e:\Work\WEB\wxxy-class\src\js\city-picker.data.js", "JavaScript", 0, 0, 0, 4014, 47, 6, 4067
"e:\Work\WEB\wxxy-class\src\js\city-picker.js", "JavaScript", 0, 0, 0, 483, 19, 78, 580
"e:\Work\WEB\wxxy-class\src\js\jQuery.js", "JavaScript", 0, 0, 0, 1, 1, 0, 2
"e:\Work\WEB\wxxy-class\src\js\main.js", "JavaScript", 0, 0, 0, 18, 22, 11, 51
"e:\Work\WEB\wxxy-class\task.php", "PHP", 193, 0, 0, 0, 8, 3, 204
"Total", "-", 4442, 8, 2499, 4518, 854, 567, 12888